EnArch Technologies=EnArch Technologies
Home=Página de Inicio
About=Sobre
Web Design=Diseñar
Tech Support=Asistencia Técnica
Software=Software
Contact=Contactar
Classes=Clases
More=Más
Store=Tienda
Language=Idioma
Technology Made Simple. Technology The Way You Want It.=Tecnología Simplificado. Tecnología Como Quiere.
About EnArch=Sobre EnArch
EnArch is a small technology company based out of Minnesota, USA, in partnership with=EnArch es una empresa pequeña en Minnesota, USA, está asociado con
We do web design, game and software development, and have a variety of original products you can purchase —— right here on our website.=Diseñamos sitios web, desarrollamos software y videojuegos, y tenemos una variedad de productos originales que usted puede comprar -- aquí en nuestro sitio web.
Although we only have a handful of "employees", we have a lot in the works and we are very dedicated to what we do. Our goal is to make technology simple, understandable, and enjoyed by all people.=Aunque tenemos un puñado de empleados, trabajamos en muchas cosas y estamos consagrados a lo que trabajamos. Nuestro objetivo es hacer technología que es sencilla, que es comprensible, y que es disfrutado por toda la gente.
Web Development=Diseño de Sitios Web
We are excited to make your dream become reality. With talented web developers experienced in HTML, CSS, PHP, and JavaScript, we are ready to take on whatever challenge you throw at us. We have low rates and are happy to make your site exactly as you want it. Once you hire us to design your website, we will update it for free whenever you want and will make sure the site gets hosted.=Estamos emocionados de hacer su sueño una realidad. Con empleados talentosos con experiencia en HTML, CSS, PHP, y JavaScript, estamos listos hacer lo que quieras. Tenemos precios bajos y vamos a hacer tu sitio web como quiere con mucho gusto. Cuando usted nos contrata para diseñar su sitio web, lo actualizaremos gratis y se aseguraremos que el sitio es en línea.
Learn More=Aprender Más
Have a computer problem? Don't know what to do? It's okay —— you've got us!=Usted tiene una problema de computadora? No sabes lo que hacer? Está bien -- nos tiene!
If you are having a technical issue, restarting your computer may fix the problem. For example, if you have an internet connection issue, you can try turning off your WiFi or router or closing your browser. If the computer simply isn't working, try restarting it.=Si usted tiene una problema técnico, es posible que reiniciar tu computadora arregle la problema. Por ejemplo, si tiene una problema con conexión a internet, puede tratar de apagar tu WiFi o router o tratar de cerrar su navigador. Si el computadora no funciona, usted trate de apagarlo.
If a restart doesn't fix it,=Si apagarlo no reinicia,
take a look at our=usted mire nuestro
If your problem isn't listed there, we will be happy to take a look.=Si tu problema no es en el FAQ, estaremos contentos mirarlo.
Game and Software Development=Desarrollo de Software y Videojuegos
Here at EnArch, we take enjoyment in designing games and software. We have people ready to design using C++, TES/CS, and CryEngine.=Aquí en EnArch, nos gusta diseñar videojuegos y software. Tenemos empleados que están listos diseñar con C++, TES/CS, y CryEngine.
View Games and Software=Ver Videojuegos y Software
We have a variety of products available for purchase, here on our site. We use PayPal to place our orders, but you don't need a PayPal account to buy products from us! Visit our store for more information.=Nosotros tenemos una variedad de productos en nuestro sitio web. Usamos PayPal para ordenar, ¡pero usted no necesita una cuenta de PayPal para comprar productos! Visite nuestra tienda para más información.
Visit the Store=Visitar la Tienda
Contact Us=Contactarnos
Feel free to contact us for feedback, questions, or business inquiries at:=Usted puede contactarnos por reacciónes, preguntas, o para consultar sobre empresa por: